{
"height":17,
"width":30,
"data":[64, 64, 64, 64, 64, 64, 64, 64, 64, 64, 64, 64, 64, 64, 64, 64, 64, 64, 64, 64, 64, 64, 64, 64, 64, 64, 64, 64, 64, 64,
        64, 64, 64, 64, 64, 64, 64, 64, 64, 64, 64, 64, 64, 64, 64, 64, 64, 64, 64, 64, 64, 64, 64, 64, 64, 64, 64, 64, 64, 64,
        64, 64, 64, 64, 64, 64, 64, 64, 64, 64, 64, 64, 64, 64, 64, 64, 64, 64, 64, 64, 64, 64, 64, 39, 59, 59, 20, 64, 64, 64,
		64, 64, 64, 64, 64, 39, 59, 59, 59, 20, 64, 64, 64, 64, 64, 64, 64, 64, 64, 64, 64, 64, 64, 49, 10, 10, 30, 64, 64, 64,
		64, 64, 64, 64, 64, 49, 10, 10, 10, 30, 64, 64, 64, 64, 64, 64, 64, 64, 64, 64, 64, 64, 64, 64, 64, 64, 64, 64, 64, 64,
		64, 64, 64, 64, 64, 64, 64, 64, 64, 64, 64, 64, 64, 64, 64, 64, 64, 64, 64, 64, 64, 64, 64, 64, 64, 64, 64, 64, 64, 64,
		64, 64, 64, 64, 64, 64, 64, 64, 64, 64, 64, 64, 64, 64, 64, 64, 39, 59, 20, 64, 64, 64, 64, 64, 64, 64, 64, 64, 64, 64,
		64, 64, 64, 64, 64, 64, 64, 64, 64, 64, 64, 64, 64, 64, 64, 64, 49, 10, 30, 64, 64, 64, 64, 64, 64, 64, 64, 64, 64, 64,
		64, 64, 64, 64, 64, 64, 64, 64, 64, 64, 64, 64, 64, 64, 64, 64, 64, 64, 64, 64, 64, 64, 64, 64, 64, 64, 64, 64, 64, 64,
		64, 64, 64, 64, 64, 64, 64, 64, 64, 64, 64, 64, 64, 64, 64, 64, 64, 64, 64, 64, 64, 64, 64, 64, 64, 64, 64, 64, 64, 64,
		64, 5, 5, 5, 64, 64, 64, 64, 64, 64, 64, 64, 64, 64, 64, 64, 64, 64, 64, 64, 64, 55, 57, 64, 64, 64, 64, 64, 64, 64,
		64, 14, 62, 16, 64, 64, 64, 64, 64, 64, 64, 64, 64, 64, 64, 64, 64, 64, 64, 64, 64, 56, 58, 64, 64, 64, 64, 64, 64, 64,
		5, 6, 6, 6, 5, 64, 64, 64, 64, 64, 64, 64, 64, 64, 64, 64, 64, 64, 64, 64, 64, 56, 58, 64, 64, 64, 64, 64, 64, 64,
		3, 62, 63, 3, 3, 64, 64, 64, 64, 64, 64, 64, 64, 64, 64, 64, 64, 64, 64, 51, 53, 9, 58, 64, 64, 64, 64, 64, 64, 64,
		3, 62, 17, 3, 3, 64, 64, 64, 64, 64, 64, 64, 64, 64, 64, 64, 64, 64, 64, 52, 54, 19, 58, 64, 64, 64, 64, 64, 64, 64,
		1, 1, 1, 1, 1, 1, 1, 1, 1, 1, 1, 1, 1, 1, 1, 1, 1, 1, 1, 1, 1, 1, 1, 1, 1, 1, 1, 1, 1, 1,
		1, 1, 1, 1, 1, 1, 1, 1, 1, 1, 1, 1, 1, 1, 1, 1, 1, 1, 1, 1, 1, 1, 1, 1, 1, 1, 1, 1, 1, 1],
"LevelLoaders":[
                {"id":4, "name":"LevelLoader1","width":16, "height":32, "x":304, "y":208}],
"Ground":[
            {"id":5, "name":"Ground1", "width":32, "height":32, "x":304, "y":208}, 
			{"id":6, "name":"Ground2", "width":32, "height":80, "x":336, "y":160}, 
			{"id":8, "name":"Ground3", "width":480, "height":32, "x":0, "y":240} ]
}