{
"height":17,
"width":164,
"PlayerPositions":[
					{"id":0, "x":32, "y":208}],
"data":[32, 32, 32, 32, 32, 32, 32, 32, 32, 32, 32, 32, 32, 32, 32, 32, 32, 32, 32, 32, 32, 32, 32, 32, 32, 32, 32, 32, 32, 32, 32, 32, 32, 32, 32, 32, 32, 32, 32, 32, 32, 32, 32, 32, 32, 32, 32, 32, 32, 32, 32, 32, 32, 32, 32, 32, 32, 32, 32, 32, 32, 32, 32, 32, 32, 32, 32, 32, 32, 32, 32, 32, 32, 32, 32, 32, 32, 32, 32, 32, 32, 32, 32, 32, 32, 32, 32, 32, 32, 32, 32, 32, 32, 32, 32, 32, 32, 32, 32, 32, 32, 32, 32, 32, 32, 32, 32, 32, 32, 32, 32, 32, 32, 32, 32, 32, 32, 32, 32, 32, 32, 32, 32, 32, 32, 32, 32, 32, 32, 32, 32, 32, 32, 32, 32, 32, 32, 32, 32, 32, 32, 32, 32, 32, 32, 32, 32, 32, 32, 32, 32, 32, 32, 32, 32, 32, 32, 32, 32, 32, 32, 32, 32, 32,
        32, 32, 32, 32, 32, 32, 32, 32, 32, 32, 32, 32, 32, 32, 32, 32, 32, 32, 32, 32, 32, 32, 32, 32, 32, 32, 32, 32, 32, 32, 32, 32, 32, 32, 32, 32, 32, 32, 32, 32, 32, 32, 32, 32, 32, 5, 25, 25, 16, 32, 32, 32, 32, 32, 32, 32, 32, 32, 32, 32, 32, 32, 32, 32, 32, 32, 32, 32, 32, 32, 32, 32, 32, 32, 32, 32, 32, 32, 32, 32, 32, 32, 32, 32, 32, 32, 32, 32, 32, 32, 32, 32, 32, 32, 32, 32, 32, 32, 32, 32, 32, 32, 32, 32, 32, 32, 32, 32, 32, 32, 32, 32, 32, 32, 32, 32, 32, 32, 32, 32, 32, 32, 32, 32, 32, 32, 32, 32, 32, 32, 32, 32, 32, 32, 32, 32, 32, 32, 32, 32, 32, 32, 32, 32, 32, 32, 32, 32, 32, 32, 32, 32, 32, 32, 32, 32, 32, 32, 32, 32, 32, 32, 32, 32,
        32, 32, 32, 32, 32, 32, 32, 32, 32, 32, 32, 32, 32, 32, 32, 32, 5, 25, 25, 16, 32, 32, 32, 32, 32, 32, 32, 32, 32, 32, 32, 32, 32, 32, 32, 32, 32, 32, 32, 32, 32, 32, 32, 32, 32, 15, 6, 6, 26, 32, 32, 32, 32, 32, 32, 32, 32, 32, 32, 32, 32, 32, 32, 32, 32, 32, 5, 25, 25, 16, 32, 32, 32, 32, 32, 32, 32, 32, 32, 32, 32, 32, 32, 32, 32, 32, 32, 32, 32, 32, 32, 32, 5, 25, 16, 32, 32, 32, 32, 32, 32, 32, 32, 32, 32, 32, 32, 32, 32, 32, 32, 32, 32, 32, 32, 32, 32, 32, 32, 32, 32, 32, 32, 32, 32, 32, 32, 32, 32, 32, 5, 25, 16, 32, 32, 32, 32, 32, 32, 32, 32, 32, 32, 32, 32, 32, 32, 32, 32, 32, 32, 32, 32, 32, 32, 32, 32, 32, 32, 32, 32, 32, 5, 25,
        32, 32, 32, 32, 5, 25, 25, 16, 32, 32, 32, 32, 32, 32, 32, 32, 15, 6, 6, 26, 32, 32, 32, 32, 32, 32, 32, 32, 32, 32, 32, 32, 32, 32, 32, 32, 32, 32, 32, 32, 32, 32, 32, 32, 32, 32, 32, 32, 32, 32, 32, 32, 32, 32, 32, 32, 32, 32, 32, 32, 32, 32, 32, 32, 32, 32, 15, 6, 6, 26, 32, 32, 32, 32, 32, 32, 32, 32, 32, 32, 32, 32, 32, 32, 32, 32, 32, 32, 32, 32, 32, 32, 15, 6, 26, 32, 32, 32, 32, 32, 32, 32, 32, 32, 32, 32, 32, 5, 25, 25, 16, 32, 32, 32, 32, 32, 32, 32, 32, 32, 32, 32, 32, 32, 32, 32, 32, 32, 32, 32, 15, 6, 26, 32, 32, 32, 32, 32, 32, 32, 32, 32, 32, 32, 32, 32, 32, 32, 32, 32, 32, 32, 32, 32, 32, 32, 32, 32, 32, 32, 32, 32, 15, 6,
        32, 32, 32, 32, 15, 6, 6, 26, 32, 32, 32, 32, 32, 32, 32, 32, 32, 32, 32, 32, 32, 32, 32, 32, 32, 32, 32, 32, 32, 32, 32, 32, 32, 32, 32, 32, 32, 32, 32, 32, 32, 32, 32, 32, 32, 32, 32, 32, 32, 32, 32, 32, 32, 32, 32, 32, 32, 32, 32, 32, 32, 32, 32, 32, 32, 32, 32, 32, 32, 32, 32, 32, 32, 32, 32, 32, 32, 32, 32, 32, 32, 32, 32, 32, 32, 32, 32, 32, 32, 32, 32, 32, 32, 32, 32, 32, 32, 32, 32, 32, 32, 32, 32, 32, 32, 32, 32, 15, 6, 6, 26, 32, 32, 32, 32, 32, 32, 32, 32, 32, 32, 32, 32, 32, 32, 32, 32, 32, 32, 32, 32, 32, 32, 32, 32, 32, 32, 32, 32, 32, 32, 32, 32, 32, 32, 32, 32, 32, 32, 32, 32, 24, 32, 32, 32, 32, 32, 32, 22, 22, 22, 32, 32, 32,
        32, 32, 32, 32, 32, 32, 32, 32, 32, 32, 32, 32, 32, 32, 32, 32, 32, 32, 32, 32, 32, 32, 32, 32, 32, 32, 32, 32, 32, 32, 32, 32, 32, 32, 32, 32, 32, 32, 32, 32, 32, 32, 32, 32, 32, 32, 32, 32, 32, 32, 32, 32, 32, 32, 32, 32, 32, 32, 32, 32, 32, 32, 32, 32, 32, 32, 32, 32, 32, 32, 32, 32, 32, 32, 32, 32, 32, 32, 32, 32, 32, 32, 32, 32, 32, 32, 32, 32, 32, 32, 32, 32, 32, 32, 32, 32, 32, 32, 32, 32, 32, 32, 32, 32, 32, 32, 32, 32, 32, 32, 32, 32, 32, 32, 32, 32, 32, 32, 32, 32, 32, 32, 32, 32, 32, 32, 32, 32, 32, 32, 32, 32, 32, 32, 32, 32, 32, 32, 32, 32, 32, 32, 32, 32, 31, 31, 32, 32, 32, 32, 32, 34, 32, 5, 25, 16, 32, 32, 41, 2, 43, 32, 32, 32,
        32, 32, 32, 32, 32, 32, 32, 32, 32, 32, 32, 32, 32, 32, 32, 32, 32, 32, 32, 32, 32, 32, 32, 32, 32, 32, 32, 32, 32, 32, 32, 32, 32, 32, 32, 32, 32, 32, 5, 25, 12, 13, 13, 13, 13, 13, 14, 32, 32, 32, 32, 32, 32, 32, 32, 32, 32, 32, 32, 32, 12, 13, 13, 14, 32, 32, 32, 32, 32, 32, 32, 32, 32, 32, 32, 32, 12, 13, 13, 13, 13, 14, 32, 32, 32, 32, 32, 32, 32, 32, 32, 32, 32, 32, 32, 32, 32, 32, 32, 32, 32, 32, 32, 32, 32, 32, 32, 32, 32, 32, 32, 32, 32, 32, 32, 32, 32, 32, 32, 32, 32, 32, 32, 32, 32, 32, 32, 32, 32, 32, 32, 32, 32, 32, 32, 32, 32, 32, 32, 32, 32, 32, 32, 32, 31, 31, 32, 32, 32, 32, 32, 34, 32, 15, 6, 26, 32, 22, 23, 23, 23, 22, 32, 32,
        32, 32, 32, 32, 32, 32, 32, 32, 32, 32, 32, 32, 32, 32, 32, 32, 32, 32, 32, 32, 32, 32, 32, 32, 32, 32, 12, 13, 13, 13, 14, 32, 32, 32, 32, 32, 32, 32, 15, 6, 26, 11, 11, 11, 11, 11, 32, 32, 32, 32, 32, 32, 32, 32, 32, 32, 21, 32, 32, 32, 32, 11, 11, 32, 32, 32, 32, 32, 32, 32, 32, 32, 32, 32, 32, 32, 32, 11, 11, 11, 11, 32, 32, 32, 32, 21, 21, 21, 32, 32, 32, 32, 32, 32, 32, 32, 21, 21, 32, 32, 32, 12, 13, 13, 13, 13, 13, 13, 14, 32, 32, 32, 32, 32, 32, 32, 32, 32, 32, 32, 32, 32, 32, 32, 32, 32, 32, 32, 32, 32, 32, 32, 32, 32, 32, 32, 32, 32, 32, 32, 32, 32, 31, 31, 31, 31, 32, 32, 32, 32, 32, 34, 32, 32, 32, 32, 32, 2, 2, 4, 2, 2, 32, 32,
        32, 32, 32, 32, 32, 32, 32, 32, 32, 32, 32, 5, 25, 16, 32, 32, 32, 32, 32, 32, 32, 32, 32, 32, 32, 32, 32, 11, 11, 11, 32, 32, 32, 32, 32, 32, 32, 32, 32, 32, 32, 11, 11, 11, 11, 11, 32, 32, 32, 32, 32, 32, 32, 32, 32, 32, 32, 32, 32, 32, 32, 11, 11, 32, 32, 32, 32, 32, 32, 32, 32, 32, 32, 21, 21, 32, 32, 11, 11, 11, 11, 32, 32, 32, 32, 32, 32, 32, 32, 32, 32, 32, 32, 32, 32, 32, 32, 32, 32, 32, 32, 32, 11, 11, 11, 11, 11, 11, 32, 32, 32, 32, 32, 32, 32, 32, 32, 32, 32, 32, 32, 32, 32, 32, 32, 21, 21, 21, 21, 32, 32, 32, 32, 32, 32, 32, 32, 32, 32, 32, 32, 32, 31, 31, 31, 31, 32, 32, 32, 32, 32, 34, 32, 32, 32, 32, 32, 2, 2, 35, 2, 2, 32, 32,
        32, 32, 32, 32, 32, 32, 32, 32, 32, 32, 32, 15, 6, 26, 32, 32, 32, 32, 32, 32, 32, 32, 32, 32, 32, 32, 32, 11, 11, 11, 32, 32, 32, 32, 32, 5, 25, 16, 32, 32, 32, 11, 11, 11, 11, 11, 32, 32, 32, 32, 32, 32, 32, 32, 32, 32, 32, 32, 32, 32, 32, 11, 11, 32, 32, 32, 32, 32, 32, 32, 32, 32, 32, 32, 32, 32, 32, 11, 11, 11, 11, 32, 32, 32, 5, 25, 16, 32, 32, 32, 32, 32, 32, 32, 32, 32, 32, 32, 32, 32, 32, 32, 11, 11, 11, 11, 11, 11, 32, 32, 32, 32, 32, 32, 32, 32, 32, 32, 32, 32, 32, 32, 32, 32, 32, 32, 32, 32, 32, 32, 32, 32, 32, 32, 5, 25, 16, 32, 32, 32, 31, 31, 31, 31, 31, 31, 32, 32, 32, 32, 32, 34, 32, 32, 32, 22, 22, 23, 23, 23, 23, 23, 22, 22,
        32, 22, 22, 22, 32, 32, 32, 32, 32, 32, 32, 32, 32, 32, 32, 32, 32, 32, 32, 32, 32, 32, 32, 32, 32, 32, 32, 11, 11, 11, 32, 32, 32, 32, 32, 12, 13, 13, 13, 14, 32, 11, 11, 11, 11, 11, 32, 32, 32, 32, 32, 32, 32, 32, 32, 32, 32, 32, 32, 32, 32, 11, 11, 32, 32, 32, 32, 32, 32, 32, 32, 32, 32, 32, 32, 32, 32, 11, 11, 11, 11, 32, 32, 32, 15, 6, 26, 32, 32, 32, 32, 32, 32, 32, 32, 32, 32, 32, 32, 32, 32, 32, 11, 11, 11, 11, 11, 11, 32, 32, 32, 32, 32, 32, 32, 32, 32, 32, 32, 32, 32, 32, 32, 32, 32, 32, 32, 32, 32, 32, 32, 32, 32, 32, 15, 6, 26, 32, 32, 32, 31, 31, 31, 31, 31, 31, 32, 32, 32, 32, 32, 34, 32, 32, 32, 2, 2, 2, 4, 2, 4, 2, 2, 2,
        32, 41, 42, 43, 32, 32, 32, 32, 32, 32, 32, 32, 32, 32, 32, 32, 32, 32, 32, 32, 32, 32, 32, 32, 12, 13, 13, 13, 13, 13, 13, 14, 32, 32, 32, 32, 11, 11, 11, 32, 32, 11, 11, 11, 11, 11, 32, 32, 32, 32, 32, 32, 32, 32, 21, 21, 21, 21, 21, 32, 32, 11, 11, 32, 32, 32, 32, 32, 32, 32, 12, 13, 14, 32, 32, 32, 32, 11, 11, 11, 11, 32, 32, 32, 32, 32, 32, 32, 32, 21, 21, 21, 21, 32, 32, 32, 32, 32, 32, 32, 32, 32, 11, 11, 11, 11, 11, 11, 32, 32, 32, 32, 32, 12, 13, 13, 14, 32, 32, 12, 13, 13, 14, 32, 32, 32, 32, 32, 32, 32, 32, 32, 32, 32, 32, 32, 32, 32, 31, 31, 31, 31, 31, 31, 31, 31, 32, 32, 32, 32, 32, 34, 32, 32, 32, 2, 2, 2, 35, 2, 35, 2, 2, 2,
        22, 23, 23, 23, 22, 32, 32, 32, 32, 32, 32, 32, 32, 32, 32, 32, 32, 32, 32, 32, 32, 32, 32, 32, 32, 11, 11, 11, 11, 11, 11, 32, 32, 32, 32, 32, 11, 11, 11, 32, 32, 11, 11, 11, 11, 11, 32, 5, 25, 16, 32, 32, 32, 32, 32, 32, 32, 32, 32, 32, 32, 11, 11, 32, 32, 32, 32, 32, 32, 32, 32, 11, 32, 32, 32, 32, 5, 11, 11, 11, 11, 32, 32, 32, 32, 32, 32, 32, 32, 32, 32, 32, 32, 32, 32, 32, 32, 32, 32, 32, 32, 32, 11, 11, 11, 11, 11, 11, 32, 32, 32, 32, 32, 32, 11, 11, 32, 32, 32, 32, 11, 11, 32, 32, 32, 32, 32, 32, 32, 32, 32, 32, 32, 32, 32, 32, 32, 32, 31, 31, 31, 31, 31, 31, 31, 31, 32, 32, 32, 32, 32, 34, 32, 32, 32, 2, 2, 2, 2, 2, 2, 2, 2, 2,
        2, 2, 4, 2, 2, 32, 32, 32, 32, 32, 32, 32, 32, 32, 32, 32, 32, 32, 32, 32, 32, 32, 32, 32, 32, 11, 11, 11, 11, 11, 11, 32, 32, 32, 32, 32, 11, 11, 11, 32, 32, 11, 11, 11, 11, 11, 32, 15, 6, 26, 32, 32, 32, 32, 32, 32, 32, 32, 32, 32, 32, 11, 11, 32, 32, 32, 32, 32, 32, 32, 32, 11, 32, 32, 32, 32, 15, 11, 11, 11, 11, 32, 32, 32, 32, 32, 32, 32, 32, 32, 32, 32, 32, 32, 32, 12, 13, 13, 14, 32, 32, 32, 11, 11, 11, 11, 11, 11, 32, 32, 32, 32, 32, 32, 11, 11, 32, 32, 32, 32, 11, 11, 25, 16, 32, 32, 32, 32, 32, 32, 32, 32, 32, 32, 32, 32, 31, 31, 31, 31, 31, 31, 31, 31, 31, 31, 32, 32, 32, 32, 32, 34, 32, 32, 32, 2, 2, 4, 2, 4, 2, 4, 2, 2,
        2, 2, 35, 2, 2, 32, 32, 32, 32, 32, 32, 32, 32, 32, 32, 32, 32, 32, 12, 13, 13, 14, 32, 32, 32, 11, 11, 11, 11, 11, 11, 32, 12, 13, 14, 32, 11, 11, 11, 32, 32, 11, 11, 11, 11, 11, 32, 32, 32, 32, 32, 32, 32, 32, 32, 32, 32, 32, 32, 32, 32, 11, 11, 32, 32, 32, 32, 32, 32, 32, 32, 11, 32, 32, 32, 32, 32, 11, 11, 11, 11, 32, 32, 32, 32, 32, 32, 32, 32, 32, 32, 32, 32, 32, 32, 32, 11, 11, 32, 32, 32, 32, 11, 11, 11, 11, 11, 11, 32, 32, 32, 32, 32, 32, 11, 11, 32, 32, 32, 32, 11, 11, 6, 26, 32, 32, 32, 32, 32, 32, 32, 32, 32, 32, 32, 32, 31, 31, 31, 31, 31, 31, 31, 31, 31, 31, 32, 32, 32, 32, 32, 31, 32, 32, 32, 2, 2, 35, 2, 35, 2, 35, 2, 2,
        1, 1, 1, 1, 1, 1, 1, 1, 1, 1, 1, 1, 1, 1, 1, 1, 32, 32, 32, 11, 11, 32, 32, 32, 32, 11, 11, 11, 11, 11, 11, 32, 32, 11, 32, 32, 11, 11, 11, 32, 32, 11, 11, 11, 11, 11, 32, 32, 32, 32, 12, 13, 13, 14, 32, 32, 32, 32, 32, 12, 13, 13, 13, 14, 32, 12, 13, 13, 13, 14, 32, 11, 32, 32, 32, 32, 32, 11, 11, 11, 11, 32, 32, 32, 32, 32, 32, 32, 32, 32, 32, 32, 32, 32, 32, 32, 11, 11, 32, 32, 32, 32, 11, 11, 11, 11, 11, 11, 32, 32, 12, 13, 14, 32, 11, 11, 32, 32, 32, 32, 11, 11, 32, 32, 32, 32, 32, 32, 32, 1, 1, 1, 1, 1, 1, 1, 1, 1, 1, 1, 1, 1, 1, 1, 1, 1, 1, 1, 1, 1, 1, 1, 1, 1, 1, 1, 1, 1, 1, 1, 1, 1, 1, 1,
        1, 1, 1, 1, 1, 1, 1, 1, 1, 1, 1, 1, 1, 1, 1, 1, 32, 32, 32, 11, 11, 32, 32, 32, 32, 11, 11, 11, 11, 11, 11, 32, 32, 11, 32, 32, 11, 11, 11, 32, 32, 11, 11, 11, 11, 11, 32, 32, 32, 32, 32, 11, 11, 32, 32, 32, 32, 32, 32, 32, 11, 11, 11, 32, 32, 32, 11, 11, 11, 32, 32, 11, 32, 32, 32, 32, 32, 11, 11, 11, 11, 32, 32, 32, 32, 32, 32, 32, 32, 32, 32, 32, 32, 32, 32, 32, 11, 11, 32, 32, 32, 32, 11, 11, 11, 11, 11, 11, 32, 32, 32, 11, 32, 32, 11, 11, 32, 32, 32, 32, 11, 11, 32, 32, 32, 32, 32, 32, 32, 1, 1, 1, 1, 1, 1, 1, 1, 1, 1, 1, 1, 1, 1, 1, 1, 1, 1, 1, 1, 1, 1, 1, 1, 1, 1, 1, 1, 1, 1, 1, 1, 1, 1, 1],
"Coins":[
            {"id":1,"name":"Coin1","x":432,"y":96}, 
            {"id":2,"name":"Coin2","x":448,"y":96}, 
            {"id":3,"name":"Coin3","x":464,"y":96}, 
            {"id":4,"name":"Coin4","x":528,"y":208}, 
            {"id":5,"name":"Coin5","x":608,"y":80}, 
            {"id":6,"name":"Coin6","x":624,"y":80}, 
            {"id":7,"name":"Coin7","x":800,"y":128}, 
            {"id":8,"name":"Coin8","x":816,"y":128}, 
            {"id":9,"name":"Coin10","x":960,"y":80}, 
            {"id":10,"name":"Coin11","x":976,"y":80}, 
            {"id":11,"name":"Coin12","x":992,"y":80}, 
            {"id":12,"name":"Coin13","x":1008,"y":80}, 
            {"id":13,"name":"Coin9","x":928,"y":160}, 
            {"id":14,"name":"Coin14","x":1408,"y":96}, 
            {"id":15,"name":"Coin15","x":1440,"y":128}, 
            {"id":16,"name":"Coin16","x":1456,"y":160}, 
            {"id":17,"name":"Coin17","x":1568,"y":192}, 
            {"id":18,"name":"Coin18","x":1760,"y":224}, 
            {"id":19,"name":"Coin19","x":1776,"y":224}, 
            {"id":20,"name":"Coin20","x":1792,"y":224}, 
            {"id":21,"name":"Coin21","x":1872,"y":128}, 
            {"id":22,"name":"Coin22","x":1888,"y":128}, 
            {"id":23,"name":"Coin23","x":2048,"y":112}, 
            {"id":24,"name":"Coin24","x":2352,"y":224}, 
            {"id":25,"name":"Coin25","x":2368,"y":224}],
"Enemys":[
            {"id":26,"name":"Enemy1","x":336,"y":208}, 
            {"id":27,"name":"Enemy2","x":624,"y":144}, 
            {"id":28,"name":"Enemy3","x":720,"y":80}, 
            {"id":29,"name":"Enemy4","x":1104,"y":224}, 
            {"id":30,"name":"Enemy5","x":1712,"y":96}],
"Ground":[
            {"id":31,"name":"Ground1","width":256,"height":32,"x":0,"y":240}, 
            {"id":32,"name":"Ground2","width":32,"height":32,"x":304,"y":240}, 
            {"id":33,"name":"Ground3","width":64,"height":16,"x":288,"y":224}, 
            {"id":34,"name":"Ground4","width":96,"height":80,"x":400,"y":192}, 
            {"id":35,"name":"Ground5","width":128,"height":16,"x":384,"y":176}, 
            {"id":36,"name":"Ground6","width":48,"height":48,"x":432,"y":128}, 
            {"id":37,"name":"Ground7","width":80,"height":16,"x":416,"y":112}, 
            {"id":38,"name":"Ground8","width":16,"height":32,"x":528,"y":240}, 
            {"id":39,"name":"Ground9","width":48,"height":16,"x":512,"y":224}, 
            {"id":40,"name":"Ground10","width":48,"height":96,"x":576,"y":176}, 
            {"id":41,"name":"Ground11","width":80,"height":16,"x":560,"y":160}, 
            {"id":42,"name":"Ground12","width":80,"height":160,"x":656,"y":112}, 
            {"id":44,"name":"Ground13","width":112,"height":16,"x":640,"y":96}, 
            {"id":45,"name":"Ground14","width":32,"height":16,"x":816,"y":256}, 
            {"id":46,"name":"Ground15","width":64,"height":16,"x":800,"y":240}, 
            {"id":47,"name":"Ground16","width":80,"height":16,"x":864,"y":176}, 
            {"id":48,"name":"Ground17","width":32,"height":16,"x":896,"y":112}, 
            {"id":49,"name":"Ground18","width":48,"height":16,"x":960,"y":256}, 
            {"id":50,"name":"Ground19","width":80,"height":16,"x":944,"y":240}, 
            {"id":51,"name":"Ground20","width":32,"height":128,"x":976,"y":112}, 
            {"id":52,"name":"Ground21","width":64,"height":16,"x":960,"y":96}, 
            {"id":53,"name":"Ground22","width":48,"height":16,"x":1056,"y":256}, 
            {"id":54,"name":"Ground23","width":80,"height":16,"x":1040,"y":240}, 
            {"id":55,"name":"Ground24","width":16,"height":80,"x":1136,"y":192}, 
            {"id":56,"name":"Ground25","width":48,"height":16,"x":1120,"y":176}, 
            {"id":57,"name":"Ground26","width":32,"height":16,"x":1168,"y":128}, 
            {"id":58,"name":"Ground27","width":64,"height":160,"x":1232,"y":112}, 
            {"id":59,"name":"Ground28","width":96,"height":16,"x":1216,"y":96}, 
            {"id":60,"name":"Ground29","width":48,"height":16,"x":1360,"y":112}, 
            {"id":61,"name":"Ground30","width":64,"height":16,"x":1424,"y":176}, 
            {"id":62,"name":"Ground31","width":32,"height":48,"x":1536,"y":224}, 
            {"id":63,"name":"Ground32","width":64,"height":16,"x":1520,"y":208}, 
            {"id":64,"name":"Ground33","width":32,"height":16,"x":1536,"y":112}, 
            {"id":65,"name":"Ground34","width":16,"height":16,"x":1552,"y":48}, 
            {"id":67,"name":"Ground35","width":96,"height":144,"x":1632,"y":128}, 
            {"id":68,"name":"Ground36","width":128,"height":16,"x":1616,"y":112}, 
            {"id":69,"name":"Ground37","width":16,"height":16,"x":1776,"y":256}, 
            {"id":71,"name":"Ground38","width":48,"height":16,"x":1760,"y":240}, 
            {"id":72,"name":"Ground39","width":32,"height":80,"x":1824,"y":192}, 
            {"id":73,"name":"Ground40","width":64,"height":16,"x":1808,"y":176}, 
            {"id":74,"name":"Ground41","width":32,"height":80,"x":1920,"y":192}, 
            {"id":75,"name":"Ground42","width":64,"height":16,"x":1904,"y":176}, 
            {"id":76,"name":"Ground43","width":64,"height":16,"x":2000,"y":128}, 
            {"id":78,"name":"Ground44","width":560,"height":32,"x":2064,"y":240}, 
            {"id":80,"name":"Ground45","width":32,"height":160,"x":2304,"y":80}, 
            {"id":81,"name":"Ground46","width":32,"height":128,"x":2272,"y":112}, 
            {"id":82,"name":"Ground47","width":32,"height":96,"x":2240,"y":144}, 
            {"id":83,"name":"Ground48","width":32,"height":64,"x":2208,"y":176}, 
            {"id":84,"name":"Ground49","width":32,"height":32,"x":2176,"y":208}],
"Keys":[
			{"id":1, "name":"Key1", "x":480, "y":160},
			{"id":2, "name":"Key2", "x":960, "y":224},
			{"id":2, "name":"Key2", "x":1712, "y":96}],
"QuestionMark":[
			{"id":1, "name":"QuestionMark1", "x":912, "y":112},
			{"id":2, "name":"QuestionMark2", "x":1552, "y":48}]
}