{
"height":17,
"width":40,
"PlayerPositions":[
					{"id":0, "x":48, "y":192}],
"data":[64, 64, 64, 64, 64, 64, 64, 64, 64, 64, 64, 64, 64, 64, 64, 64, 64, 64, 64, 64, 64, 64, 64, 64, 64, 64, 64, 64, 64, 64, 64, 64, 64, 64, 64, 64, 64, 64, 64, 64,
        64, 64, 64, 64, 64, 64, 64, 64, 64, 64, 64, 64, 64, 64, 64, 64, 64, 64, 64, 64, 64, 64, 64, 64, 64, 64, 64, 64, 64, 64, 64, 64, 64, 64, 64, 64, 64, 64, 64, 64,
        64, 64, 64, 64, 64, 64, 64, 64, 64, 64, 64, 64, 64, 64, 64, 64, 64, 64, 64, 64, 64, 64, 64, 64, 64, 64, 64, 64, 64, 64, 64, 64, 64, 64, 64, 64, 64, 64, 64, 64,
        64, 64, 64, 64, 64, 39, 59, 59, 20, 64, 64, 64, 64, 64, 64, 64, 64, 64, 64, 64, 64, 64, 64, 64, 64, 64, 64, 64, 64, 64, 64, 64, 39, 59, 59, 59, 20, 64, 64, 64,
        64, 64, 64, 64, 64, 49, 10, 10, 30, 64, 64, 64, 64, 64, 64, 64, 64, 64, 64, 64, 64, 64, 64, 64, 64, 64, 64, 28, 64, 64, 64, 64, 49, 10, 10, 10, 30, 64, 64, 64,
        64, 64, 64, 64, 64, 64, 64, 64, 64, 64, 64, 64, 64, 64, 64, 64, 64, 64, 64, 64, 64, 64, 39, 59, 20, 64, 64, 38, 64, 64, 64, 64, 64, 64, 64, 64, 64, 64, 64, 64,
        64, 64, 64, 64, 64, 64, 64, 64, 64, 64, 64, 64, 64, 64, 64, 64, 64, 64, 64, 64, 64, 64, 49, 10, 30, 64, 64, 38, 64, 64, 64, 64, 64, 64, 64, 64, 64, 64, 64, 64,
        64, 64, 64, 64, 64, 64, 64, 64, 64, 64, 64, 64, 64, 64, 11, 11, 64, 64, 64, 64, 64, 64, 64, 64, 64, 64, 64, 38, 64, 64, 64, 64, 64, 64, 64, 64, 64, 64, 64, 64,
        64, 64, 64, 64, 64, 64, 64, 64, 64, 64, 64, 64, 64, 11, 11, 11, 64, 64, 64, 64, 64, 64, 64, 64, 64, 64, 64, 38, 64, 64, 64, 64, 64, 64, 64, 64, 64, 64, 64, 64,
        64, 64, 64, 64, 64, 64, 64, 64, 64, 64, 64, 64, 11, 11, 11, 11, 64, 64, 64, 64, 64, 64, 64, 3, 3, 64, 64, 38, 64, 64, 64, 64, 64, 64, 64, 64, 64, 64, 64, 64,
        64, 64, 64, 64, 64, 64, 64, 64, 64, 64, 64, 11, 11, 11, 11, 11, 64, 64, 64, 64, 64, 64, 64, 64, 64, 64, 64, 38, 64, 64, 64, 64, 5, 5, 5, 64, 64, 64, 64, 64,
        64, 64, 64, 64, 64, 64, 64, 64, 64, 64, 11, 11, 11, 11, 11, 11, 64, 64, 64, 29, 3, 3, 64, 64, 64, 64, 64, 38, 64, 64, 64, 64, 14, 3, 16, 64, 64, 64, 64, 64,
        64, 64, 64, 64, 64, 64, 64, 64, 64, 11, 11, 11, 11, 11, 11, 11, 64, 64, 64, 64, 64, 44, 64, 64, 64, 64, 64, 38, 64, 64, 64, 5, 6, 6, 6, 5, 64, 64, 64, 64,
        64, 64, 64, 55, 57, 64, 64, 64, 11, 11, 11, 11, 11, 11, 11, 11, 64, 64, 64, 64, 41, 42, 45, 64, 64, 64, 64, 38, 64, 64, 64, 3, 3, 63, 3, 3, 64, 64, 44, 64,
        64, 64, 64, 56, 58, 64, 64, 11, 11, 11, 11, 11, 11, 11, 11, 11, 64, 64, 64, 41, 42, 43, 42, 45, 64, 64, 64, 11, 64, 64, 64, 3, 3, 17, 3, 3, 48, 41, 42, 45,
        1, 1, 1, 1, 1, 1, 1, 1, 1, 1, 1, 1, 1, 1, 1, 1, 1, 1, 1, 1, 1, 1, 1, 1, 1, 1, 1, 1, 1, 1, 1, 1, 1, 1, 1, 1, 1, 1, 1, 1,
        1, 1, 1, 1, 1, 1, 1, 1, 1, 1, 1, 1, 1, 1, 1, 1, 1, 1, 1, 1, 1, 1, 1, 1, 1, 1, 1, 1, 1, 1, 1, 1, 1, 1, 1, 1, 1, 1, 1, 1],
"Ground":[
            {"id":4,"name":"Ground1","width":640,"height":32,"x":0,"y":240}, 
            {"id":5,"name":"Ground2","width":32,"height":32,"x":48,"y":208}, 
            {"id":6,"name":"Ground3","width":32,"height":128,"x":224,"y":112}, 
            {"id":7,"name":"Ground4","width":16,"height":112,"x":208,"y":128}, 
            {"id":8,"name":"Ground5", "width":16,"height":96,"x":192,"y":144}, 
            {"id":9,"name":"Ground6","width":16,"height":80,"x":176,"y":160}, 
            {"id":10,"name":"Ground7","width":16,"height":64,"x":160,"y":176}, 
            {"id":11,"name":"Ground8","width":16,"height":48,"x":144,"y":192}, 
            {"id":12,"name":"Ground9","width":16, "height":32,"x":128,"y":208}, 
            {"id":13,"name":"Ground10","width":16,"height":16,"x":112,"y":224}, 
            {"id":14,"name":"Ground11","width":48,"height":16,"x":304,"y":176}, 
            {"id":15,"name":"Ground12","width":32, "height":16,"x":368,"y":144}],

"Coins":[
            {"id":1,"name":"Coin1","x":384,"y":128 }],
"MapLoader":[
                {"id":29,"name":"MapLoader1","height":80,"width":80,"x":496,"y":160, "textureFilePath":"Textures/TexturesLevel_1_3.txt", "mapJsonPath":"Tiles//JsonFiles/Level1_3.json", "playerPositionId":0, "tag":"castle"}],
"Enemys":[
            {"id":2, "name":"Enemy1","x":400,"y":224}]
}