{
"height":17,
"width":192,
"PlayerPositions":[
					{"id":0, "x":48, "y":16},
					{"id":1, "x":1840, "y":176}],
"data":[15, 15, 15, 15, 15, 15, 15, 15, 15, 15, 15, 15, 15, 15, 15, 15, 15, 15, 15, 15, 15, 15, 15, 15, 15, 15, 15, 15, 15, 15, 15, 15, 15, 15, 15, 15, 15, 15, 15, 15, 15, 15, 15, 15, 15, 15, 15, 15, 15, 15, 15, 15, 15, 15, 15, 15, 15, 15, 15, 15, 15, 15, 15, 15, 15, 15, 15, 15, 15, 15, 15, 15, 15, 15, 15, 15, 15, 15, 15, 15, 15, 15, 15, 15, 15, 15, 15, 15, 15, 15, 15, 15, 15, 15, 15, 15, 15, 15, 15, 15, 15, 15, 15, 15, 15, 15, 15, 15, 15, 15, 15, 15, 15, 15, 15, 15, 15, 15, 15, 15, 15, 15, 15, 15, 15, 15, 15, 15, 15, 15, 15, 15, 15, 15, 15, 15, 15, 15, 15, 15, 15, 15, 15, 15, 15, 15, 15, 15, 15, 15, 15, 15, 15, 15, 15, 15, 15, 15, 15, 15, 15, 15, 15, 15, 15, 15, 15, 15, 15, 15, 15, 15, 15, 15, 15, 15, 15, 15, 15, 15, 15, 15, 15, 15, 15, 15, 15, 15, 15, 15, 15, 15,
		15, 15, 15, 15, 15, 15, 15, 15, 15, 15, 15, 15, 15, 15, 15, 15, 15, 15, 15, 15, 15, 15, 15, 15, 15, 15, 15, 15, 15, 15, 15, 15, 15, 15, 15, 15, 15, 15, 15, 15, 15, 15, 15, 15, 15, 15, 15, 15, 15, 15, 15, 15, 15, 15, 15, 15, 15, 15, 15, 15, 15, 15, 15, 15, 15, 15, 15, 15, 15, 15, 15, 15, 15, 15, 15, 15, 15, 15, 15, 15, 15, 15, 15, 15, 15, 15, 15, 15, 15, 15, 15, 15, 15, 15, 15, 15, 15, 15, 15, 15, 15, 15, 15, 15, 15, 15, 15, 15, 15, 15, 15, 15, 15, 15, 15, 15, 15, 15, 15, 15, 15, 15, 15, 15, 15, 15, 15, 15, 15, 15, 15, 15, 15, 15, 15, 15, 15, 15, 15, 15, 15, 15, 15, 15, 15, 15, 15, 15, 15, 15, 15, 15, 15, 15, 15, 15, 15, 15, 15, 15, 15, 15, 15, 15, 15, 15, 15, 15, 15, 15, 15, 15, 15, 15, 15, 15, 15, 15, 15, 15, 15, 15, 15, 15, 15, 15, 15, 15, 15, 15, 15, 15,
		15, 15, 15, 15, 15, 15, 15, 15, 15, 15, 15, 15, 15, 15, 15, 15, 15, 15, 15, 15, 15, 15, 15, 15, 15, 15, 15, 15, 15, 15, 15, 15, 15, 15, 15, 15, 15, 15, 15, 15, 15, 15, 15, 15, 15, 15, 15, 15, 15, 15, 15, 15, 15, 15, 15, 15, 15, 15, 15, 15, 15, 15, 15, 15, 15, 15, 15, 15, 15, 15, 15, 15, 15, 15, 15, 15, 15, 15, 15, 15, 15, 15, 15, 15, 15, 15, 15, 15, 15, 15, 15, 15, 15, 15, 15, 15, 15, 15, 15, 15, 15, 15, 15, 15, 15, 15, 15, 15, 15, 15, 15, 15, 15, 15, 15, 15, 15, 15, 15, 15, 15, 15, 15, 15, 15, 15, 15, 15, 15, 15, 15, 15, 15, 15, 15, 15, 15, 15, 15, 15, 15, 15, 15, 15, 15, 15, 15, 15, 15, 15, 15, 15, 15, 15, 15, 15, 15, 15, 15, 15, 15, 15, 15, 15, 15, 15, 15, 15, 15, 15, 15, 15, 15, 15, 15, 15, 15, 15, 15, 15, 15, 15, 15, 15, 15, 15, 15, 15, 15, 15, 15, 15,
		3, 15, 15, 15, 15, 15, 3, 3, 3, 3, 3, 3, 3, 3, 3, 3, 3, 3, 3, 3, 3, 3, 3, 3, 3, 3, 3, 3, 3, 3, 3, 3, 3, 3, 3, 3, 3, 3, 3, 3, 3, 3, 3, 3, 3, 3, 3, 3, 3, 3, 3, 3, 3, 3, 3, 3, 3, 3, 3, 3, 3, 3, 3, 3, 3, 3, 3, 3, 3, 3, 3, 3, 3, 3, 3, 3, 3, 3, 3, 3, 3, 3, 3, 3, 3, 3, 3, 3, 3, 3, 3, 3, 3, 3, 3, 3, 3, 3, 3, 3, 3, 3, 3, 3, 3, 3, 3, 3, 3, 3, 3, 3, 3, 3, 3, 3, 3, 3, 3, 3, 3, 3, 3, 3, 3, 3, 3, 3, 3, 3, 3, 3, 3, 3, 3, 3, 3, 3, 15, 15, 15, 15, 15, 15, 15, 15, 15, 15, 15, 15, 15, 15, 15, 15, 15, 15, 15, 15, 15, 15, 3, 3, 3, 3, 3, 3, 3, 3, 41, 44, 3, 3, 3, 3, 3, 3, 3, 3, 3, 3, 3, 3, 3, 3, 3, 3, 15, 15, 15, 15, 3, 3,
		3, 15, 15, 15, 15, 15, 15, 15, 15, 15, 15, 15, 15, 15, 15, 15, 15, 15, 15, 15, 15, 15, 15, 15, 15, 15, 15, 15, 15, 15, 15, 15, 15, 15, 15, 15, 15, 15, 15, 15, 15, 15, 15, 15, 15, 15, 15, 15, 15, 15, 15, 15, 15, 15, 15, 3, 3, 15, 15, 3, 3, 3, 3, 3, 3, 15, 15, 3, 3, 3, 3, 15, 15, 15, 15, 15, 15, 3, 3, 3, 15, 15, 15, 15, 15, 15, 15, 15, 15, 15, 15, 15, 15, 15, 15, 15, 15, 15, 15, 15, 15, 15, 15, 15, 15, 15, 15, 15, 15, 15, 15, 15, 15, 15, 15, 15, 15, 15, 15, 15, 15, 15, 15, 15, 15, 15, 15, 15, 15, 15, 15, 15, 15, 15, 15, 15, 15, 15, 15, 15, 15, 15, 15, 15, 15, 15, 15, 15, 15, 15, 15, 15, 15, 15, 15, 15, 15, 15, 15, 15, 15, 15, 15, 15, 15, 15, 15, 15, 41, 44, 3, 3, 3, 3, 3, 3, 3, 15, 15, 15, 15, 15, 15, 15, 15, 15, 15, 15, 15, 15, 3, 3,
		3, 15, 15, 15, 15, 15, 15, 15, 15, 15, 15, 15, 15, 15, 15, 15, 15, 15, 15, 15, 15, 15, 15, 15, 15, 15, 15, 15, 15, 15, 15, 15, 15, 15, 15, 15, 15, 15, 15, 15, 15, 15, 15, 15, 15, 15, 15, 15, 15, 15, 15, 15, 15, 15, 15, 3, 3, 15, 15, 3, 3, 3, 3, 3, 3, 15, 15, 3, 3, 3, 3, 15, 15, 15, 15, 15, 15, 3, 3, 3, 15, 15, 15, 15, 15, 15, 15, 15, 15, 15, 15, 15, 15, 15, 15, 15, 15, 15, 15, 15, 15, 15, 15, 15, 15, 15, 15, 15, 15, 15, 15, 15, 15, 15, 15, 15, 15, 15, 15, 15, 15, 15, 15, 15, 15, 15, 15, 15, 15, 15, 15, 15, 15, 15, 15, 15, 15, 15, 15, 15, 15, 15, 15, 15, 15, 15, 15, 15, 15, 15, 15, 15, 15, 15, 15, 15, 15, 15, 15, 15, 15, 15, 15, 15, 15, 15, 15, 15, 41, 44, 3, 3, 3, 3, 3, 3, 3, 15, 15, 15, 15, 15, 15, 15, 15, 15, 15, 15, 15, 15, 3, 3,
		3, 15, 15, 15, 15, 15, 15, 15, 15, 15, 15, 15, 15, 15, 15, 15, 15, 15, 15, 15, 15, 15, 15, 15, 15, 15, 15, 15, 15, 15, 15, 15, 15, 15, 15, 15, 15, 15, 15, 15, 15, 15, 15, 15, 15, 15, 15, 15, 15, 15, 15, 15, 15, 3, 3, 15, 15, 15, 15, 15, 15, 15, 15, 3, 3, 15, 15, 15, 3, 15, 15, 15, 15, 3, 3, 15, 15, 15, 15, 15, 15, 15, 15, 15, 15, 15, 15, 15, 15, 15, 15, 15, 15, 15, 15, 15, 15, 15, 15, 15, 15, 15, 15, 15, 15, 15, 15, 15, 15, 15, 15, 15, 15, 15, 15, 15, 15, 15, 15, 15, 15, 15, 15, 15, 15, 15, 15, 15, 15, 15, 15, 15, 15, 15, 15, 15, 15, 15, 15, 15, 15, 15, 15, 15, 15, 15, 15, 15, 15, 15, 15, 15, 15, 15, 15, 15, 3, 3, 3, 15, 15, 15, 15, 15, 15, 15, 15, 15, 41, 44, 3, 3, 3, 3, 3, 3, 3, 15, 15, 15, 15, 15, 15, 15, 15, 15, 15, 15, 15, 15, 3, 3,
		3, 15, 15, 15, 15, 15, 15, 15, 15, 15, 15, 15, 15, 15, 15, 15, 15, 15, 15, 15, 15, 15, 15, 15, 15, 15, 15, 15, 15, 15, 15, 15, 15, 15, 15, 15, 15, 15, 15, 15, 15, 15, 15, 15, 15, 15, 15, 15, 15, 15, 15, 15, 15, 3, 3, 15, 15, 15, 15, 15, 15, 15, 15, 3, 3, 15, 15, 15, 3, 15, 15, 15, 15, 3, 3, 15, 15, 15, 15, 15, 15, 15, 15, 15, 15, 15, 15, 15, 15, 15, 15, 15, 15, 15, 15, 15, 15, 15, 15, 15, 15, 15, 15, 15, 15, 15, 15, 15, 15, 15, 15, 15, 15, 15, 15, 15, 15, 15, 15, 15, 15, 15, 15, 15, 15, 15, 15, 15, 15, 15, 15, 15, 15, 15, 15, 15, 15, 15, 15, 15, 15, 15, 15, 15, 15, 15, 15, 15, 15, 15, 15, 15, 15, 15, 15, 15, 15, 15, 15, 15, 15, 15, 15, 15, 15, 15, 15, 15, 41, 44, 3, 3, 3, 3, 3, 3, 3, 15, 15, 15, 15, 15, 15, 15, 15, 15, 15, 15, 15, 15, 3, 3,
		3, 15, 15, 15, 15, 15, 15, 15, 15, 15, 15, 15, 15, 15, 15, 15, 15, 15, 15, 15, 15, 15, 15, 15, 15, 15, 15, 15, 15, 15, 15, 15, 15, 15, 15, 15, 15, 15, 15, 15, 15, 15, 15, 15, 15, 15, 15, 15, 15, 15, 15, 15, 15, 3, 3, 15, 15, 15, 15, 15, 15, 15, 15, 3, 3, 15, 15, 15, 3, 15, 15, 15, 15, 3, 3, 15, 15, 15, 15, 15, 15, 15, 15, 15, 15, 15, 15, 15, 15, 15, 15, 15, 15, 15, 15, 15, 15, 15, 15, 15, 15, 15, 15, 15, 15, 15, 15, 15, 15, 15, 15, 15, 15, 15, 15, 15, 15, 15, 15, 15, 15, 15, 15, 15, 15, 15, 15, 15, 15, 15, 15, 15, 15, 15, 15, 15, 15, 15, 15, 15, 3, 3, 3, 15, 15, 15, 15, 15, 15, 15, 15, 15, 15, 15, 15, 15, 15, 15, 15, 15, 15, 15, 15, 15, 15, 15, 15, 15, 41, 44, 3, 3, 3, 3, 3, 3, 3, 15, 15, 15, 15, 15, 15, 15, 15, 15, 15, 15, 15, 15, 3, 3,
		3, 15, 15, 15, 15, 15, 15, 15, 15, 15, 15, 15, 15, 15, 15, 15, 15, 15, 15, 15, 15, 15, 15, 15, 15, 15, 15, 15, 15, 15, 15, 15, 15, 15, 15, 15, 15, 15, 15, 15, 3, 15, 3, 3, 3, 3, 15, 3, 15, 15, 15, 15, 15, 3, 3, 15, 15, 15, 15, 15, 15, 15, 15, 3, 3, 15, 15, 15, 3, 15, 15, 15, 15, 3, 3, 15, 15, 15, 15, 15, 15, 15, 15, 15, 3, 3, 3, 3, 3, 3, 15, 15, 15, 15, 15, 15, 15, 15, 15, 15, 15, 15, 15, 15, 15, 15, 15, 15, 15, 15, 15, 15, 15, 15, 15, 15, 15, 15, 15, 15, 15, 15, 15, 15, 15, 15, 15, 15, 15, 15, 15, 15, 15, 15, 15, 15, 15, 15, 15, 15, 15, 15, 15, 15, 15, 15, 15, 15, 15, 15, 15, 15, 15, 3, 3, 3, 15, 15, 15, 15, 15, 15, 15, 15, 15, 15, 15, 15, 41, 44, 3, 3, 3, 3, 3, 3, 3, 15, 15, 15, 15, 15, 15, 15, 15, 15, 15, 15, 15, 15, 3, 3,
		3, 15, 15, 15, 15, 15, 15, 15, 15, 15, 15, 15, 15, 15, 15, 15, 15, 15, 15, 15, 15, 15, 15, 15, 15, 15, 15, 15, 15, 15, 3, 15, 15, 15, 15, 15, 15, 15, 15, 15, 3, 15, 3, 15, 15, 3, 15, 3, 15, 15, 15, 15, 15, 3, 3, 15, 15, 15, 15, 15, 15, 15, 15, 3, 3, 15, 15, 15, 3, 15, 3, 15, 15, 3, 3, 15, 15, 15, 15, 15, 15, 15, 15, 15, 3, 3, 3, 3, 3, 3, 15, 15, 15, 15, 15, 15, 15, 15, 15, 15, 15, 15, 15, 15, 15, 15, 15, 15, 15, 15, 15, 15, 15, 15, 15, 15, 15, 15, 15, 15, 15, 15, 15, 15, 15, 15, 15, 15, 15, 15, 15, 15, 15, 15, 15, 15, 15, 15, 15, 15, 15, 15, 15, 15, 15, 15, 15, 15, 15, 15, 15, 15, 15, 15, 15, 15, 15, 15, 15, 15, 15, 15, 15, 15, 15, 15, 33, 35, 37, 44, 3, 3, 3, 3, 3, 3, 3, 15, 15, 15, 15, 15, 15, 15, 15, 15, 15, 15, 15, 15, 3, 3,
		3, 15, 15, 15, 15, 15, 15, 15, 15, 15, 15, 40, 40, 40, 40, 40, 15, 15, 15, 15, 15, 15, 15, 15, 9, 15, 9, 15, 15, 15, 15, 15, 15, 15, 15, 15, 15, 15, 15, 15, 3, 3, 3, 15, 15, 3, 3, 3, 15, 15, 15, 15, 15, 3, 3, 3, 3, 15, 15, 3, 3, 3, 3, 3, 3, 15, 15, 15, 3, 3, 3, 15, 15, 3, 3, 15, 15, 3, 3, 3, 15, 15, 15, 15, 15, 15, 15, 15, 15, 15, 15, 15, 15, 15, 15, 15, 15, 15, 15, 15, 15, 15, 15, 15, 15, 15, 15, 15, 15, 42, 43, 15, 15, 15, 15, 15, 15, 15, 15, 15, 15, 15, 15, 15, 15, 15, 15, 15, 15, 15, 15, 15, 15, 15, 15, 15, 9, 9, 15, 15, 15, 15, 15, 15, 15, 3, 3, 3, 3, 3, 15, 15, 15, 15, 15, 15, 15, 15, 15, 15, 15, 15, 15, 15, 15, 15, 34, 38, 36, 44, 3, 3, 3, 3, 3, 3, 3, 15, 15, 15, 15, 15, 15, 15, 15, 15, 15, 15, 15, 15, 3, 3,
		3, 15, 15, 15, 15, 15, 15, 15, 15, 15, 15, 15, 15, 15, 15, 15, 15, 15, 15, 15, 15, 15, 9, 15, 9, 15, 9, 15, 9, 15, 15, 15, 9, 15, 15, 15, 15, 15, 15, 15, 15, 15, 15, 15, 15, 15, 15, 15, 15, 15, 15, 15, 15, 15, 15, 3, 3, 15, 15, 15, 15, 15, 15, 15, 15, 15, 15, 15, 15, 15, 15, 15, 15, 15, 15, 15, 15, 15, 15, 15, 15, 15, 15, 15, 15, 15, 15, 15, 15, 15, 15, 15, 15, 15, 15, 15, 15, 15, 15, 15, 15, 15, 15, 42, 43, 15, 15, 15, 15, 41, 44, 15, 15, 15, 15, 15, 15, 15, 15, 15, 15, 15, 3, 3, 15, 15, 15, 15, 15, 15, 15, 15, 15, 15, 15, 9, 9, 9, 15, 15, 15, 15, 15, 15, 15, 15, 15, 15, 15, 15, 15, 15, 15, 15, 15, 15, 15, 15, 15, 15, 3, 3, 3, 3, 3, 3, 3, 3, 3, 3, 3, 3, 3, 3, 3, 3, 3, 15, 42, 43, 15, 15, 42, 43, 15, 15, 42, 43, 15, 15, 3, 3,
		3, 15, 15, 15, 15, 15, 15, 15, 15, 15, 15, 15, 15, 15, 15, 15, 15, 15, 9, 15, 9, 15, 9, 15, 9, 15, 9, 15, 9, 15, 15, 15, 9, 15, 9, 15, 15, 15, 15, 15, 15, 15, 15, 15, 15, 15, 15, 15, 15, 15, 15, 15, 15, 15, 15, 15, 15, 15, 15, 15, 15, 15, 15, 15, 15, 15, 15, 15, 15, 15, 15, 15, 15, 15, 15, 15, 15, 15, 15, 15, 15, 15, 15, 15, 15, 15, 15, 15, 15, 15, 15, 15, 15, 15, 15, 15, 15, 15, 15, 15, 15, 15, 15, 41, 44, 15, 15, 15, 15, 41, 44, 15, 15, 15, 15, 42, 43, 15, 15, 15, 15, 15, 3, 3, 15, 15, 15, 15, 15, 15, 15, 15, 15, 15, 9, 9, 9, 9, 15, 15, 15, 15, 15, 15, 15, 15, 15, 15, 15, 15, 15, 15, 15, 15, 15, 15, 15, 15, 15, 15, 3, 3, 3, 3, 3, 3, 3, 3, 3, 3, 3, 3, 3, 3, 3, 3, 3, 15, 41, 44, 15, 15, 41, 44, 15, 15, 41, 44, 15, 15, 3, 3,
		3, 15, 15, 15, 15, 15, 15, 15, 15, 15, 15, 15, 15, 15, 15, 15, 15, 15, 9, 15, 9, 15, 9, 15, 9, 15, 9, 15, 9, 15, 15, 15, 9, 15, 9, 15, 15, 15, 15, 15, 15, 15, 15, 15, 15, 15, 15, 15, 15, 15, 15, 15, 15, 15, 15, 15, 15, 15, 15, 15, 15, 15, 15, 15, 15, 15, 15, 15, 15, 15, 15, 15, 15, 15, 15, 15, 15, 15, 15, 15, 15, 15, 15, 15, 15, 15, 15, 15, 15, 15, 15, 15, 15, 15, 15, 15, 15, 15, 15, 15, 15, 15, 15, 41, 44, 15, 15, 15, 15, 41, 44, 15, 15, 15, 15, 41, 44, 15, 15, 15, 15, 15, 3, 3, 15, 15, 15, 15, 15, 15, 15, 15, 15, 9, 9, 9, 9, 9, 15, 15, 15, 15, 15, 15, 15, 15, 15, 15, 15, 15, 15, 15, 15, 15, 15, 15, 15, 15, 15, 15, 3, 3, 3, 3, 3, 3, 3, 3, 3, 3, 3, 3, 3, 3, 3, 3, 3, 15, 41, 44, 15, 15, 41, 44, 15, 15, 41, 44, 15, 15, 3, 3,
		1, 1, 1, 1, 1, 1, 1, 1, 1, 1, 1, 1, 1, 1, 1, 1, 1, 1, 1, 1, 1, 1, 1, 1, 1, 1, 1, 1, 1, 1, 1, 1, 1, 1, 1, 1, 1, 1, 1, 1, 1, 1, 1, 1, 1, 1, 1, 1, 1, 1, 1, 1, 1, 1, 1, 1, 1, 1, 1, 1, 1, 1, 1, 1, 1, 1, 1, 1, 1, 1, 1, 1, 1, 1, 1, 1, 1, 1, 1, 1, 15, 15, 15, 1, 1, 1, 1, 1, 1, 1, 1, 1, 1, 1, 1, 1, 1, 1, 1, 1, 1, 1, 1, 1, 1, 1, 1, 1, 1, 1, 1, 1, 1, 1, 1, 1, 1, 1, 1, 1, 15, 15, 1, 1, 15, 15, 1, 1, 1, 1, 1, 1, 1, 1, 1, 1, 1, 1, 15, 15, 15, 15, 15, 15, 15, 1, 1, 1, 1, 1, 1, 1, 1, 15, 15, 15, 15, 15, 15, 15, 1, 1, 1, 1, 1, 1, 1, 1, 1, 1, 1, 1, 1, 1, 1, 1, 1, 1, 1, 1, 1, 1, 1, 1, 1, 1, 1, 1, 1, 1, 1, 1,
		1, 1, 1, 1, 1, 1, 1, 1, 1, 1, 1, 1, 1, 1, 1, 1, 1, 1, 1, 1, 1, 1, 1, 1, 1, 1, 1, 1, 1, 1, 1, 1, 1, 1, 1, 1, 1, 1, 1, 1, 1, 1, 1, 1, 1, 1, 1, 1, 1, 1, 1, 1, 1, 1, 1, 1, 1, 1, 1, 1, 1, 1, 1, 1, 1, 1, 1, 1, 1, 1, 1, 1, 1, 1, 1, 1, 1, 1, 1, 1, 15, 15, 15, 1, 1, 1, 1, 1, 1, 1, 1, 1, 1, 1, 1, 1, 1, 1, 1, 1, 1, 1, 1, 1, 1, 1, 1, 1, 1, 1, 1, 1, 1, 1, 1, 1, 1, 1, 1, 1, 15, 15, 1, 1, 15, 15, 1, 1, 1, 1, 1, 1, 1, 1, 1, 1, 1, 1, 15, 15, 15, 15, 15, 15, 15, 1, 1, 1, 1, 1, 1, 1, 1, 15, 15, 15, 15, 15, 15, 15, 1, 1, 1, 1, 1, 1, 1, 1, 1, 1, 1, 1, 1, 1, 1, 1, 1, 1, 1, 1, 1, 1, 1, 1, 1, 1, 1, 1, 1, 1, 1, 1],
"Ground":[
            {"id":40, "name":"Ground1", "width":16, "height":192, "x":0, "y":48},
			{"id":43, "name":"Ground2", "width":1280, "height":32, "x":0, "y":240},
			{"id":44, "name":"Ground3", "width":592, "height":32, "x":1328, "y":240},
			{"id":45, "name":"Ground4", "width":32, "height":80, "x":1952, "y":192},
			{"id":47, "name":"Ground5", "width":192, "height":32, "x":2016, "y":240},
			{"id":49, "name":"Ground6", "width":128, "height":32, "x":2320, "y":240},
			{"id":50, "name":"Ground7", "width":512, "height":32, "x":2560, "y":240},
			{"id":52, "name":"Ground8", "width":32, "height":192, "x":3040, "y":48},
			{"id":53, "name":"Ground9", "width":112, "height":192, "x":2720, "y":48},
			{"id":54, "name":"Ground10", "width":144, "height":16, "x":2832, "y":48},
			{"id":55, "name":"Ground11", "width":160, "height":48, "x":2560, "y":192},
			{"id":56, "name":"Ground12", "width":128, "height":16, "x":2560, "y":48},
			{"id":57, "name":"Ground13", "width":32, "height":144, "x":2688, "y":48},
			{"id":58, "name":"Ground14", "width":32, "height":32, "x":2656, "y":160},
			{"id":59, "name":"Ground15", "width":32, "height":48, "x":2848, "y":192},
			{"id":60, "name":"Ground16", "width":32, "height":48, "x":2912, "y":192},
			{"id":61, "name":"Ground17", "width":32, "height":48, "x":2976, "y":192},
			{"id":62, "name":"Ground18", "width":48, "height":16, "x":2496, "y":96},
			{"id":64, "name":"Ground19", "width":48, "height":16, "x":2448, "y":144},
			{"id":65, "name":"Ground20", "width":80, "height":16, "x":2320, "y":176},
			{"id":67, "name":"Ground21", "width":48, "height":16, "x":2240, "y":128},
			{"id":68, "name":"Ground22", "width":32, "height":64, "x":2176, "y":176},
			{"id":69, "name":"Ground23", "width":16, "height":48, "x":2160, "y":192},
			{"id":70, "name":"Ground24", "width":16, "height":32, "x":2144, "y":208},
			{"id":71, "name":"Ground25", "width":16, "height":16, "x":2128, "y":224},
			{"id":75, "name":"Ground26", "width":2112, "height":16, "x":96, "y":48},
			{"id":76, "name":"Ground27", "width":80, "height":16, "x":176, "y":176},
			{"id":77, "name":"Ground28", "width":16, "height":32, "x":288, "y":208},
			{"id":78, "name":"Ground29", "width":16, "height":32, "x":320, "y":208},
			{"id":79, "name":"Ground30", "width":16, "height":48, "x":352, "y":192},
			{"id":80, "name":"Ground31", "width":16, "height":64, "x":384, "y":176},
			{"id":80, "name":"Ground32", "width":16, "height":64, "x":416, "y":176},
			{"id":80, "name":"Ground33", "width":16, "height":48, "x":448, "y":192},
			{"id":83, "name":"Ground34", "width":16, "height":16, "x":480, "y":160},
			{"id":85, "name":"Ground35", "width":16, "height":48, "x":512, "y":192},
			{"id":88, "name":"Ground36", "width":16, "height":32, "x":544, "y":208},
			{"id":89, "name":"Ground37", "width":16, "height":32, "x":640, "y":144},
			{"id":92, "name":"Ground38", "width":16, "height":48, "x":672, "y":144},
			{"id":93, "name":"Ground39", "width":16, "height":48, "x":720, "y":144},
			{"id":94, "name":"Ground40", "width":16, "height":48, "x":752, "y":144},
			{"id":95, "name":"Ground41", "width":32, "height":16, "x":640, "y":176},
			{"id":96, "name":"Ground42", "width":32, "height":16, "x":688, "y":144},
			{"id":97, "name":"Ground43", "width":16, "height":16, "x":736, "y":176},
			{"id":98, "name":"Ground44", "width":32, "height":96, "x":848, "y":96},
			{"id":99, "name":"Ground45", "width":32, "height":32, "x":880, "y":64},
			{"id":100, "name":"Ground46", "width":32, "height":32, "x":880, "y":176},
			{"id":101, "name":"Ground47", "width":96, "height":32, "x":944, "y":64},
			{"id":102, "name":"Ground48", "width":32, "height":96, "x":1008, "y":96},
			{"id":103, "name":"Ground49", "width":64, "height":16, "x":944, "y":176},
			{"id":104, "name":"Ground50", "width":64, "height":32, "x":1072, "y":64},
			{"id":105, "name":"Ground51", "width":16, "height":96, "x":1088, "y":96},
			{"id":106, "name":"Ground52", "width":32, "height":16, "x":1104, "y":176},
			{"id":107, "name":"Ground53", "width":16, "height":16, "x":1120, "y":160},
			{"id":108, "name":"Ground54", "width":32, "height":96, "x":1168, "y":96},
			{"id":109, "name":"Ground55", "width":48, "height":32, "x":1232, "y":64},
			{"id":110, "name":"Ground56", "width":48, "height":16, "x":1232, "y":176},
			{"id":111, "name":"Ground57", "width":96, "height":32, "x":1344, "y":144},
			{"id":112, "name":"Ground58", "width":32, "height":48, "x":1648, "y":192},
			{"id":113, "name":"Ground59", "width":32, "height":64, "x":1744, "y":176},
			{"id":114, "name":"Ground60", "width":32, "height":32, "x":1840, "y":208}],
"Coins":[
            {"id":1, "name":"Coin1", "x":240,"y":160}, 
            {"id":2, "name":"Coin2", "x":368, "y":224}, 
            {"id":3, "name":"Coin4", "x":656, "y":160}, 
            {"id":4, "name":"Coin4", "x":736, "y":160},
			{"id":5, "name":"Coin5", "x":672, "y":128}, 
            {"id":6, "name":"Coin6", "x":688, "y":128}, 
            {"id":7, "name":"Coin7", "x":704, "y":128}, 
            {"id":8, "name":"Coin8", "x":720, "y":128}, 
            {"id":9, "name":"Coin9", "x":944, "y":160}, 
            {"id":10, "name":"Coin10", "x":960, "y":160}, 
            {"id":11, "name":"Coin11", "x":976, "y":160}, 
            {"id":12, "name":"Coin12", "x":992, "y":160}, 
            {"id":14, "name":"Coin13", "x":1104, "y":160}, 
            {"id":21, "name":"Coin14", "x":1344, "y":112}, 
            {"id":22, "name":"Coin15", "x":1360, "y":112}, 
            {"id":23, "name":"Coin17", "x":1392, "y":112}, 
            {"id":24, "name":"Coin16", "x":1376, "y":112}, 
            {"id":25, "name":"Coin18", "x":1408, "y":112}, 
            {"id":26, "name":"Coin19", "x":1424, "y":112}, 
            {"id":27, "name":"Coin20", "x":2528, "y":80}, 
            {"id":28, "name":"Coin21", "x":2592, "y":32}, 
            {"id":29, "name":"Coin22", "x":2608, "y":32}],
"Enemys":[
            {"id":30, "name":"Enemy1", "x":256, "y":224}, 
            {"id":34, "name":"Enemy2", "x":1072, "y":224}, 
            {"id":35, "name":"Enemy3", "x":1248, "y":224}, 
            {"id":36, "name":"Enemy4", "x":1440, "y":224}, 
            {"id":37, "name":"Enemy5", "x":2112, "y":224}, 
            {"id":38, "name":"Enemy6", "x":2416, "y":224}],
"MapLoader":[
                {"id":112, "name":"MapLoader1", "x":1648, "y":192, "width":32, "height":16, "textureFilePath":"Textures/TexturesLevel_1_2_2.txt", "mapJsonPath":"Tiles//JsonFiles/Level1_2_3.json", "playerPositionId":0 , "tag":"tube"}, 
                {"id":115, "name":"MapLoader3", "x":2656, "y":160, "width":16, "height":32, "textureFilePath":"Textures/TexturesLevel_1_2_4.txt", "mapJsonPath":"Tiles//JsonFiles/Level1_2_4.json","playerPositionId":0, "tag":"castle"}],
"Keys":[
			{"id":1, "name":"Key1", "x":256, "y":224},
			{"id":2, "name":"Key2", "x":880, "y":160},
			{"id":2, "name":"Key2", "x":2432, "y":224}]
}